
NO      ./textures/redbrick.xpm
SO ./textures/wood.xpm
WE               ./textures/colorstone.xpm
EA ./textures/mossy.xpm

F       220,100,0
C            255,15,0


1111111111111111111111111
1000000000110000000000001
1010000001110000000000000
1001000000000000000000001
111111111011000001110000000000001
100000000011000001110111111111111
11110111111111011100000010001
11110111111111011101010010001
11000000110101011100000010001
10000000000000001100000010001
100000000000N00001101010010001
1100000111010101111101111000111
11111111111111  111111111111111111
