
NO ./textures/colorstone.xpm
SO ./textures/mossy.xpm
WE ./textures/redbrick.xpm
WE ./textures/redbrick.xpm
EA ./textures/wood.xpm

F 220,100,0
C 200,30,0

1111111111111111111111111
1000S00000110000000000001
101000000111000000000N0001
1001000000000000000000001
111111111011000001110000000000001
100000000011000001110111111111111
11110111111111011100000010001
11110111111111011101010010001
11000000110101011100000010001
10000000000000001100000010001
100000000000S00001101010010001
11000001110101011111011110N0111
11111111111111  111111111111111111
